津山路子	津山 路子
広瀬嘉子	広瀬 嘉子
隅田恵子	隅田 恵子
塩沢登代路	塩沢 登代路
立花満枝	立花 満枝
木匠久美子	木匠 久美子
原節子	原 節子
池部良	池部 良
島崎雪子	島崎 雪子
杉葉子	杉 葉子
大谷友右衛門	大谷 友右衛門
山根寿子	山根 寿子
高千穂ひずる	高千穂 ひずる
有馬稲子	有馬 稲子
浅芽しのぶ	浅芽 しのぶ
八千草薫	八千草 薫
長谷川季子	長谷川 季子
新珠三千代	新珠 三千代
山口淑子	山口 淑子
三船敏郎	三船 敏郎
浜田百合子	浜田 百合子
若山セツ子	若山 セツ子
中北千枝子	中北 千枝子
春日野八千代	春日野 八千代
榎本健一	榎本 健一
越路吹雪	越路 吹雪
沢村契恵子	沢村 契恵子
田代百合子	田代 百合子
木匠マユリ	木匠 マユリ
島秋子	島 秋子
岡田茉莉子	岡田 茉莉子	岡田茉利子	岡田 茉利子
久慈あさみ	久慈 あさみ
青山京子	青山 京子
伊吹まり	伊吹 まり
奈良あけみ	奈良 あけみ
竹野美子	竹野 美子
メリー松原	メリー 松原
重山規子	重山 規子
尾上さくら	尾上 さくら
根岸あけみ	根岸 あけみ
久保明	久保 明
山田真二	山田 真二
中村扇雀	中村 扇雀
司葉子	司 葉子
雪村いづみ	雪村 いづみ
草笛光子	草笛 光子
宝田明	宝田 明
小泉博	小泉 博
安西郷子	安西 郷子
津島恵子	津島 恵子
佐原健二	佐原 健二
中田喜子	中田 喜子
白川由美	白川 由美
小林桂樹	小林 桂樹
香川京子	香川 京子
淡路恵子	淡路 恵子
森繁久彌	森繁 久彌
岩井半四郎	岩井 半四郎
嵯峨三智子	嵯峨 三智子
根岸明美	根岸 明美
宮城まり子	宮城 まり子
有島一郎	有島 一郎
三木のり平	三木 のり平
乙羽信子	乙羽 信子
加東大介	加東 大介
河津清三郎	河津 清三郎
中田康子	中田 康子
河内桃子	河内 桃子
団令子	団 令子
江原達怡	江原 達怡
扇千景	扇 千景
福田富子	福田 富子
鶴田浩二	鶴田 浩二
フランキー堺	フランキー 堺
上原美佐	上原 美佐
水野久美	水野 久美
三井美奈	三井 美奈
三橋達也	三橋 達也
上條美佐保	上條 美佐保	上条美佐保	上条 美佐保
中島そのみ	中島 そのみ
原知佐子	原 知佐子
北あけみ	北 あけみ
星由里子	星 由里子
浜美枝	浜 美枝
田村奈己	田村 奈己
若松久代	若松 久代
桜井節子	桜井 節子
内海安江	内海 安江
藤井輝子	藤井 輝子
林八重子	林 八重子
横田米子	横田 米子	梅田米子	梅田 米子
尤敏	尤 敏
藤山陽子	藤山 陽子
若林映子	若林 映子
浜木綿子	浜 木綿子
浜木綿子	浜木 綿子
中真千子	中 真千子
柳川慶子	柳川 慶子
笹るみ子	笹 るみ子
池内淳子	池内 淳子
英由美	英 由美
立川真理	立川 真理
大空真弓	大空 真弓
南弘子	南 弘子
鈴木加代子	鈴木 加代子
中川ゆき	中川 ゆき
高石かつ枝	高石 かつ枝
桜井浩子	桜井 浩子
寿美花代	寿美 花代
水谷良重	水谷 良重
ロミ山田	ロミ 山田
喜浦節子	喜浦 節子
前田美波里	前田 美波里
張美瑶	張 美瑶
西尾恵美子	西尾 恵美子
内藤洋子	内藤 洋子
沢井桂子	沢井 桂子
高橋紀子	高橋 紀子
淀かほる	淀 かほる
亀谷静子	亀谷 静子
河本芳子	河本 芳子
西川純代	西川 純代
藤あきみ	藤 あきみ
酒井和歌子	酒井 和歌子
小林夕岐子	小林 夕岐子
宮内恵子	宮内 恵子
高橋厚子	高橋 厚子
柏木由紀子	柏木 由紀子
岡田可愛	岡田 可愛
松本めぐみ	松本 めぐみ
中山麻理	中山 麻理
鹿島とも子	鹿島 とも子
浜村幸子	浜村 幸子
青木英美	青木 英美
梅田智子	梅田 智子
徳永れい子	徳永 れい子
西山恵子	西山 恵子
中野良子	中野 良子
木村由貴子	木村 由貴子
鳥居恵子	鳥居 恵子
司美智子	司 美智子
吉沢京子	吉沢 京子
石原千晶	石原 千晶
加藤小夜子	加藤 小夜子
泉扶美子	泉 扶美子
島田陽子	島田 陽子
本田みちこ	本田 みちこ
太田黒久美	太田黒 久美
関根恵子	関根 恵子
山添多佳子	山添 多佳子
皆川妙子	皆川 妙子
伊藤めぐみ	伊藤 めぐみ
黒沢のり子	黒沢 のり子
真木洋子	真木 洋子
十朱幸代	十朱 幸代
栗原小巻	栗原 小巻
甲にしき	甲 にしき
近江ツヤ子	近江 ツヤ子
新倉まり子	新倉 まり子
上月晃	上月 晃
山口百恵	山口 百恵
三林京子	三林 京子
大竹しのぶ	大竹 しのぶ
岡崎友紀	岡崎 友紀
秋吉久美子	秋吉 久美子
仁科明子	仁科 明子
古手川祐子	古手川 祐子
真野響子	真野 響子
原田美枝子	原田 美枝子
中井貴惠	中井 貴惠
檀ふみ	檀 ふみ
浅野ゆう子	浅野 ゆう子
名取裕子	名取 裕子
安奈淳	安奈 淳
多岐川裕美	多岐川 裕美
里見奈保	里見 奈保
池上希美子	池上 希美子
竹下景子	竹下 景子
松原千明	松原 千明
三原順子	三原 順子
桜田淳子	桜田 淳子
岡田奈々	岡田 奈々
坂口良子	坂口 良子
山本陽子	山本 陽子
松田聖子	松田 聖子
沢田亜矢子	沢田 亜矢子
沢口靖子	沢口 靖子
早見優	早見 優
遥くらら	遥 くらら
堀ちえみ	堀 ちえみ
斉藤由貴	斉藤 由貴
富田靖子	富田 靖子
小高恵美	小高 恵美
水野真紀	水野 真紀
今村恵子	今村 恵子
酒井法子	酒井 法子
大沢さやか	大沢 さやか
清水美砂	清水 美砂
宮本信子	宮本 信子
安達祐実	安達 祐実
一路真輝	一路 真輝
野波麻帆	野波 麻帆
田中美里	田中 美里
生田智子	生田 智子
長澤まさみ	長澤 まさみ
西田尚美	西田 尚美
菊川怜	菊川 怜
酒井美紀	酒井 美紀
常盤貴子	常盤 貴子
釈由美子	釈 由美子
大塚ちひろ	大塚 ちひろ
田中麗奈	田中 麗奈
黒瀬真奈美	黒瀬 真奈美
池澤あやか	池澤 あやか
増元裕子	増元 裕子
笹本玲奈	笹本 玲奈
貫地谷しほり	貫地谷 しほり
朝倉あき	朝倉 あき
瀬奈じゅん	瀬奈 じゅん
堀北真希	堀北 真希
大塚千弘	大塚 千弘
戸田恵梨香	戸田 恵梨香
昆夏美	昆 夏美
上白石萌音	上白石 萌音
有村架純	有村 架純
上白石萌歌	上白石 萌歌
山崎紘菜	山崎 紘菜
浜辺美波	浜辺 美波
山村紅葉	山村 紅葉
神田沙也加	神田 沙也加
広瀬すず	広瀬 すず
土屋太鳳	土屋 太鳳
朝夏まなと	朝夏 まなと
